10110110111
10110000000
10111111010
10100010010
10102000110
10100010110
10001010000
10111110110
10000110011
11110110001
00000110001