11121111
00000000
11101111
00000000
11111010
10000010
10110110
10000000