10110110111
10110000000
10111111010
10100010010
10102000110
10100010110
10001110000
10111110111
10000110011
11110111011
10000110011